11111111111111
1P000000000001
11111111111011
1E000000000C01
11111111111111